Alter = Возраст
Anfang = Начало
Angestellte = Сотрудник
Anmelgung = Регистрация
Apfelsaft = Яблочный сок
Appetit = Аппетит
Auskunft = Справка
Ausweis = Паспорт
Auto = Автомобиль
Besuch = Визит
Bier = Пиво
Buchstabe = Буква
Dank = Спасибо
Ei = Яйцо
Eis = Мороженное
Familienstand = Семейное положение
Fehler = Ошибка
Fernseher = Телевизор
Firma = Фирма
Formular = Формуляр
Führerschein = Водительскиеправа
Geburstjahr = Год рождения
Geburstort = Место рождения
Haus = Дом
Kollegin = Коллега
Kuchen = Пирог
Lampe = Лампа
Lied = Песня
Mantel = Пальто
Methode = Методика
Milch = Молоко
Mineralwasser = Минеральная вода
Monat = Месяц
Nachbar = Сосед
Nachmittag = После обеда
Orangensaft = Апельсиновый сок
Paar = Пара
Portion = Порция
Religion = Религия
Salat = Салат
Seite = Страница
Situation = Ситуация
Speisekarte = Меню
Staatsangehörigkeit = Гражданство
Straße = Улица
Stück = Кусок
Student = Студент
Suppe = Суп
Tasse = Чашка
Tür = Дверь
Wasser = Вода
Wein = Вино
Woche = Неделя
Wohnung = Квартира
Würstchen = Сосиска
Zimmer = Комната
Zentrum = Центр
Zucker = Сахар
begrüßen = приветствовать
bestellen = заказывать
besuchen = посещать
buchstabieren = писать по буквам
essen = есть
fehlen = ошибаться
geben = давать
geboren sein = родиться
gehen = идти
glauben = верить, думать
haben = иметь
helfen = помогать
klingeln = звонить
einladen = приглашать
nehmen = брать
öffnen = открывать
stehen = стоять
trinken = пить
wissen = знать
wiederholen = повторять
alt = старый
deutlich = ясный
freundlich = дружественный
hübsch = милый
international = интернациональный
geschieden = разведён
klein = маленький
langsam = медленный
laut = громкий
ledig = не женат
männlich = мужественный
neu = новый
unfreundlich = враждебный
verheiratet = женат
weiblich = женственный
wunderbar = прекрасный
also = итак
an = у (стены)
halt = мол, уж
in der Mitte = по середине
gern = с удовольствием
gleich = одинаковый, сразу
jed = каждый
jemand = кто-то
links = слева
meist = чаще всего
natürlich = конечно
nur = только
oben = сверху
rechts = справа
unten = снизу
vielleicht = возможно
wann = когда
wer = кто
wie lange = как долго
wirklich = действительно
zweimal = два раза