Abend = Вечер
Adresse = Адрес
Antwort = Ответ
Arzt = Врач
Ärtzin = Женщина врач
Biespiel = Пример
Beruf = Профессия
Bild = Картина
Computer = Компьютер
Deutsch = Немецкий
Deutschland = Германия
Entschuldigung = Извините
Europa = Европа
Fahrer = Водитель
Familie = Семья
Familienname = Фамилия
Flug = Самолёт
Flughafen = Аэропорт
Foto = Фото
Frage = Вопрос
Frau = Женщина
Freund = Друг
Friseur = Парикмахер
Gitarre = Гитара
Herr = Господин
Information = Информация
Ingenieur = Инженер
Jahr = Год
Kaffee = Кофе
Kellnerin = Официантка
Kind = Ребёнок
Kiosk = Ларёк
Kurs = Курс
Land = Страна
Lehrerin = Учительница
Leute = Люди
Mann = Мужчина
Minute = Минута
Moment = Момент
Morgen = Утро
Nachname = Фамилия
Name = Имя
Neujahr = Новый Год
Nummer = Номер
Österreich = Австрия
Pass = Паспорт
Person = Персона
Platz = Площадь
Radio = Радио
Risiko = Риск
Schokolade = Шоколад
Schweiz = Швейцария
Sofa = Диван
Sprache = Язык
Stadt = Город
Tag = День
Taxifahrer = Водитель такси
Tee = Чай
Telefon = Телефон
Telefonnummer = Телефонный номер
Text = Текст
Tourist = Турист
Vorname = Имя
Wort = Слово
Zahl = Цифра
Zeit = Время
Zettel = Записка
Zigarette = Сигарета

antoworten = отвечать
arbeiten = работать
dauern = длиться
entschuldigen = извиняться
fliegen = летать
fragen = спрашивать
heißen = звать
hören = слушать
sein = быть
kennen = знать
kommen = приходить
leben = жить
lernen = учить
lesen = читать
lieben = любить
möchten = хотеть
sagen = спрашивать
schreiben = писать
spielen = играть
sprechen = говорить
suchen = искать
wohnen = проживать

groß = большой
gut = хорошо
höflich = вежливый
richtig = правильно
willkommen = добро пожаловать

alle = все
als = в качестве
auch = так же
auf Englisch = на английском
Auf Wiedersein! = до свидания!
aus = из
bei = в (принадлежность)
bitte = пожалуйста
da = тут/там
danke = спасибо
für = для
hallo = здравствуйте
heute = сегодня
hier = здесь
immer = всегда
in - в
in der Nähe = в близи
ja = да
jetzt = сейчас
man = кто-то (3 лицо ед. число)
mit = с
nach = до, после
nein = нет
nicht = не
noch einmal = ещё раз
oder = или
schon = уже
sehr = очень
seit = с какого-то времени
tschüs = пока
und = и
unterwegs = в пути
viel = много
von = от
was = что
wenig = мало
wie = как
wo = где
woher = откуда
wohin = куда
zu = слишком
