Banane = Банан
Bonbon = Конфета
Brot = Хлеб
Bruder = Брат
Büro = Офис
Butter = Сливочное масло
Chance = Шанс
Dose = Доза, Жестяная банка
Durchsage = Сообщение
Durst = Жажда
Fisch = Рыба
Flasche = Бутылка
Fleisch = Мясо
Gang = Ряд
Geburtstag = День Рождения
Gemüse = Овощи
Gramm = Грамм
Hunger = Голод
Kartoffel = Картофель
Käse = Сыр
Kasten = Коробка, Ящик
Kilo = Килограмм
Kneipe = Кабак
Kollege = Коллега
Koffer = Чемодан
Kontakt = Контакт
Kugelschreiber = Шариковая ручка
Liter = Литр
Mehl = Мука
Messer = Нож
Mutter = Мать
Ober = Сливки
Obst = Фрукты
Öl = Масло
Orange = Апельсин
Ort = Место
Packung = Пачка, Упаковка
Paket = Пакет
Partner = Партнёр
Pfeffer = Перец
Pfund = Фунт
Problem = Проблема
Produkt = Продукт
Project = Проект
Putzmittel = Чистящие средства
Rat = Совет
Reis = Рис
Salz = Соль
Schachtel = КОробок, Пачка
Schinken = Ветчина
Sohn = Сын
Supermarkt = Супермаркет
Süßigkeit = Сладость
Taxi = Такси
Ticket = Билет
Tipp = Совет
Tochter = Дочь
Tomate = Подидор
Tüte = Кулёк, Пакет
Vater = Отец
Verien = Команда
Verzeihung = Прощение
Volkshochschule = Народный университет
Waschmittel = Моющие средства
Wunsh = Желание
Wurst = Колбаса
backen = выпекать
beginnen = начинать
beobachten = наблюдать
bitten = просить
bleiben = оставаться
denken = думать
einkaufen = делать покупки
erzählen = рассказать
gefallen = нравиться
aufhören = переставать
lächeln = улыбаться
lachen = смеяться
aufmachen = открыть
mitbringen = приносить с собой
probieren = попробовать
schenken = подарить
schreien = кричать
verstehen = понимать
warten = ждать
weinen = плакать
wünschen = желать
besser = лучше
frisch = свежий
fröhlich = весёлый
gemütlich = уютный
halb = наполовину
lang = высокий, длинный
leer = пустой
leise = тихий
kurz = коротко
nervös = нервный
rot = красный
sauer = кислый
spät = поздно
traurig = печальный
wichtig = выжный
zufrieden = довольный
am Ende = в конце
außerdem = кроме того
bald = вскоре
endlich = наконец
herein = сюда
in Ordnung = в порядке (очереди)
letzt- = последний
manchmal = иногда
nach = после, по направлению
nicht mehr = больше не
nichts = ничего
niemand = никто
Platz nehmen = занимать места
sofort = немедленно
sogar = даже
Sonst noch etwas = желаете что-то ещё
vor = до (времени)
zurück = назад
zurzeit = на сегодня